8 11
...#...#...
.a.#.@.#.a.
...#...#...
...#AAA#...
...........
...#...#...
...#.a.#...
...#...#...
